%%%%%%%%%%%%%%%%%%%%%%%%%%%%%%%%%%%%%%%%%
%P                                  .   %
% %%%% %% %%  %%%   %%%  %% %% %%  %%%% %
%  %% .%%%%%. % %   %% % %%.%%%     %%  %
%  %%  %% %% %%  %% %%  %%% %% %% %%%%% %
%                                      .%
%%%%%%%%%%%%%%%%%%%%%%%%%%%%%%%%%%%%%%%%%